30 30

111111111111111111111111111111
100000000011111111111111111111
100000000011111111111111111111
100000000011111111111111111111
100000000011111111111111111111
100000000000000001111111111111
100000000011111101111111111111
111111111111111101111111111111
111111111111111101111111111111
111111111111111101111111111111
111111111111111101111111111111
111111111110000000011111111111
111111111110000000011111111111
111111111110000000011111111111
111111111110000000011111111111
111111111111111111111111111111
111111111111111111111111111111
111111111111111111111111111111
111111111111111111111111111111
111111111111111111111111111111
111111111111111111111111111111
111111111111111111111111111111
111111111111111111111111111111
111111111111111111111111111111
111111111111111111111111111111
111111111111111111111111111111
111111111111111111111111111111
111111111111111111111111111111
111111111111111111111111111111
111111111111111111111111111111
